rokusottervanger = Rokus Ottervanger <rokusottervanger@gmail.com>
rsoetens = Robin Soetens <robinsoetens@gmail.com>
tpeters      = Ton Peters <peterstmc@gmail.com>
rwijnands   = Ramon Wijnands        <rayman747@hotmail.com>
rappeldoorn = Rein Appeldoorn       <reinzor@gmail.com>
lferreira   = Luis Ferreira         <luisfferreira@outlook.com>
bcoenen = Bas Coenen <s.a.m.coenen@student.tue.nl> 
bmrkajic = Boris Mrkajic <b.mrkajic@student.tue.nl>
bwillems = Bas Willems <b.willems@student.tue.nl>
ddimarco = Daniel Di Marco <marcodl@ipvs.uni-stuttgart.de> 
egeerts = Erik Geerts <e.g.geerts@live.nl>
emeijl = Erik van Meijl <erik.meijl@gmail.com>
hvos = Harm Vos <h.vos@student.tue.nl>
jdenissen = Jean-Pierre Denissen <j.w.c.j.denissen@student.tue.nl>
jelfring = Jos Elfring <j.elfring@tue.nl>
jheuvel = Jimmy van den Heuvel <j.v.d.heuvel@student.tue.nl>
jlunenburg = Janno Lunenburg <j.j.m.lunenburg@tue.nl>
jlunnenb = Janno Lunenburg <j.j.m.lunenburg@tue.nl>
jvdheuvel = Jimmy van den Heuvel <j.v.d.heuvel@student.tue.nl>
kbuys = Koen Buys <buys.koen@gmail.com>
kvtienhoven = Kris van Tienhoven <k.v.tienhoven@student.tue.nl>
loyvanbeek = Loy van Beek <loy.vanbeek@gmail.com>
lvbeek = Loy van Beek <loy.vanbeek@gmail.com>
marcodl = Daniel Di Marco <marcodl@ipvs.uni-stuttgart.de>
mbaeten = Max Baeten <m.j.j.baeten@student.tue.nl>
mgeelen = Mark Geelen <geelenmark17@gmail.com>
nbilterijst = Niek Bilterijst <n.e.bilterijst@student.tue.nl>
ndirkx = Nic Dirkx <n.j.dirkx@student.tue.nl>
pmetsemakers = Paul Metsemakers <p.m.g.metsemakers@student.tue.nl>
rjacobs = Ric Jacobs <h.c.m.jacobs@student.tue.nl>
rjanssen = Rob Janssen <r.j.m.janssen@tue.nl>
samcoenen = Bas Coenen <s.a.m.coenen@student.tue.nl>
sjansen = Simon Jansen <sepsimon@gmail.com>
smarinkov = Sava Marinkov <s.marinkov@tue.nl>
svddries = Sjoerd van den Dries <sjoerdvddries@gmail.com>
tclephas = Tim Clephas <t.t.g.clephas@alumnus.tue.nl>
tdejager = Tim de Jager <tdejager89@gmail.com>
tderksen = Teun Derksen <t.j.j.derksen@student.tue.nl>
tdjager = Tim de Jager <tdejager89@gmail.com>
wgeelen = Wouter Geelen <w.geelen@student.tue.nl>
zli = Ziyang Li <ziyang.d.lee@gmail.com>
mmeijs = Mark Meijs <m.j.meijs@student.tue.nl>
amigo = AMIGO <amigo@tue.nl>

